1111111111111111
1000100000100001
1000100202100001
1000100000100001
1110111000111001
1000000000001001
1000000000001001
1000000300001001
1111100000001001
1000101111001001
1000101001001001
1000101001001001
1000101001020001
1000111001000001
1000000000000001
1111111111111111
